date	dosen_kumulativ	dosen_biontech_kumulativ	dosen_biontech_erst_kumulativ	dosen_biontech_zweit_kumulativ	dosen_moderna_kumulativ	dosen_moderna_erst_kumulativ	dosen_moderna_zweit_kumulativ	dosen_astra_kumulativ	dosen_astra_erst_kumulativ	dosen_astra_zweit_kumulativ	dosen_johnson_kumulativ	dosen_erst_kumulativ	dosen_zweit_kumulativ	dosen_differenz_zum_vortag	dosen_erst_differenz_zum_vortag	dosen_zweit_differenz_zum_vortag	personen_erst_kumulativ	personen_voll_kumulativ	impf_quote_erst	impf_quote_voll	dosen_dim_kumulativ	dosen_kbv_kumulativ	indikation_alter_dosen	indikation_beruf_dosen	indikation_medizinisch_dosen	indikation_pflegeheim_dosen	indikation_alter_erst	indikation_beruf_erst	indikation_medizinisch_erst	indikation_pflegeheim_erst	indikation_alter_voll	indikation_beruf_voll	indikation_medizinisch_voll	indikation_pflegeheim_voll
2020-12-27	24157	24155	24142	13	2	2	0	0	0	0	0	24144	13	24157	24144	13	24144	13	0.0002903084624808597	1.5631254192557885e-7	0	0	0	0	0	0	0	0	0	0	0	0	0	0
2020-12-28	42188	42186	42012	174	2	2	0	0	0	0	0	42014	174	18031	17870	161	42014	174	0.0005051780874200976	0.00000209218325346544	0	0	0	0	0	0	0	0	0	0	0	0	0	0
2020-12-29	92392	92389	91474	915	2	2	0	1	1	0	0	91477	915	50204	49463	741	91477	915	0.0010999232613635522	0.000011001998143223434	0	0	0	0	0	0	0	0	0	0	0	0	0	0
2020-12-30	156219	156216	155163	1053	2	2	0	1	1	0	0	155166	1053	63827	63689	138	155166	1053	0.001865722452340336	0.000012661315895971886	0	0	0	0	0	0	0	0	0	0	0	0	0	0
2020-12-31	206049	206046	204904	1142	2	2	0	1	1	0	0	204907	1142	49830	49741	89	204907	1142	0.0024638103098726604	0.000013731455606077774	0	0	0	0	0	0	0	0	0	0	0	0	0	0
2021-01-01	231484	231473	230323	1150	7	7	0	4	3	1	0	230333	1151	25435	25426	9	230333	1151	0.0027695335937957194	0.00001383967198125702	0	0	0	0	0	0	0	0	0	0	0	0	0	0
2021-01-02	279544	279533	278097	1436	7	7	0	4	3	1	0	278107	1437	48060	47774	286	278107	1437	0.0033439701613305352	0.000017278547903619755	0	0	0	0	0	0	0	0	0	0	0	0	0	0
2021-01-03	301988	301975	300534	1441	9	9	0	4	3	1	0	300546	1442	22444	22439	5	300546	1442	0.0036137776327357708	0.00001733866811205267	0	0	0	0	0	0	0	0	0	0	0	0	0	0
2021-01-04	347931	347917	346379	1538	10	10	0	4	3	1	0	346392	1539	45943	45846	97	346392	1539	0.004165031847898855	0.000018505000155651218	0	0	0	0	0	0	0	0	0	0	0	0	0	0
2021-01-05	400276	400261	398385	1876	11	11	0	4	3	1	0	398399	1877	52345	52007	338	398399	1877	0.004790366183892976	0.00002256912624571627	0	0	0	0	0	0	0	0	0	0	0	0	0	0
2021-01-06	462963	462939	460971	1968	17	17	0	7	5	2	0	460993	1970	62687	62594	93	460993	1970	0.005542999049222952	0.00002368736212256849	0	0	0	0	0	0	0	0	0	0	0	0	0	0
2021-01-07	517660	517629	515639	1990	21	21	0	9	7	2	1	515668	1992	54697	54675	22	515668	1993	0.006200413528436877	0.000023963915081359897	0	0	0	0	0	0	0	0	0	0	0	0	0	0
2021-01-08	580033	579950	577851	2099	72	72	0	10	8	2	1	577932	2101	62373	62264	109	577932	2102	0.00694907846001028	0.000025274535625197443	0	0	0	0	0	0	0	0	0	0	0	0	0	0
2021-01-09	640202	640115	637868	2247	75	75	0	11	8	3	1	637952	2250	60169	60020	149	637952	2251	0.007670761442038991	0.00002706611783649831	0	0	0	0	0	0	0	0	0	0	0	0	0	0
2021-01-10	675984	675888	673493	2395	84	82	2	11	8	3	1	673584	2400	35782	35632	150	673584	2401	0.008099202095415316	0.000028869724089485756	0	0	0	0	0	0	0	0	0	0	0	0	0	0
2021-01-11	743954	743842	741350	2492	98	90	8	13	10	3	1	741451	2503	67970	67867	103	741451	2504	0.008915237732558643	0.000030108200383203805	0	0	0	0	0	0	0	0	0	0	0	0	0	0
2021-01-12	822703	822575	820019	2556	113	105	8	14	10	4	1	820135	2568	78749	78684	65	820135	2569	0.009861337428625739	0.000030889763092831696	0	0	0	0	0	0	0	0	0	0	0	0	0	0
2021-01-13	934225	932924	930166	2758	1286	1278	8	14	10	4	1	931455	2770	111522	111320	202	931455	2771	0.011199853749176158	0.000033318619513521465	0	0	0	0	0	0	0	0	0	0	0	0	0	0
2021-01-14	1018007	1011550	1008613	2937	6442	6390	52	14	10	4	1	1015014	2993	83782	83559	223	1015014	2994	0.012204570648465345	0.00003599998080962947	0	0	0	0	0	0	0	0	0	0	0	0	0	0
2021-01-15	1109286	1097548	1093763	3785	11718	11666	52	19	15	4	1	1105445	3841	91279	90431	848	1105445	3842	0.013291916762224732	0.000046196368159851844	0	0	0	0	0	0	0	0	0	0	0	0	0	0
2021-01-16	1166983	1153563	1148772	4791	13399	13347	52	20	16	4	1	1162136	4847	57697	56691	1006	1162136	4848	0.013973571709478808	0.00005829255409655433	0	0	0	0	0	0	0	0	0	0	0	0	0	0
2021-01-17	1214426	1199742	1178001	21741	14661	14609	52	21	17	4	2	1192629	21797	47443	30493	16950	1192629	21799	0.014340220812627784	0.00026211208472582255	0	0	0	0	0	0	0	0	0	0	0	0	0	0
2021-01-18	1296856	1278018	1240657	37361	18814	18760	54	22	18	4	2	1259437	37419	82430	66808	15622	1259437	37421	0.01514352298962502	0.00044995166395362204	0	0	0	0	0	0	0	0	0	0	0	0	0	0
2021-01-19	1416265	1393740	1320277	73463	22492	22433	59	31	27	4	2	1342739	73526	119409	83302	36107	1342739	73528	0.016145149710200757	0.000884103737131074	0	0	0	0	0	0	0	0	0	0	0	0	0	0
2021-01-20	1548312	1523030	1395787	127243	25246	25187	59	34	30	4	2	1421006	127306	132047	78267	53780	1421006	127308	0.017086235380884548	0.001530756699035507	0	0	0	0	0	0	0	0	0	0	0	0	0	0
2021-01-21	1653403	1625373	1457315	168058	27993	27933	60	35	30	5	2	1485280	168123	105091	64274	40817	1485280	168125	0.01785906863624798	0.002021542008556765	0	0	0	0	0	0	0	0	0	0	0	0	0	0
2021-01-22	1755085	1724856	1523560	201296	30183	30118	65	44	39	5	2	1553719	201366	101682	68439	33243	1553719	201368	0.018681982025236035	0.0024212572263438434	0	0	0	0	0	0	0	0	0	0	0	0	0	0
2021-01-23	1841677	1811091	1563803	247288	30537	30471	66	47	42	5	2	1594318	247359	86592	40599	45993	1594318	247361	0.019170146093669616	0.0029742789756348545	0	0	0	0	0	0	0	0	0	0	0	0	0	0
2021-01-24	1888912	1858123	1589188	268935	30736	30670	66	51	46	5	2	1619906	269006	47235	25588	21647	1619906	269008	0.019477817272345904	0.003234563406024317	0	0	0	0	0	0	0	0	0	0	0	0	0	0
2021-01-25	1979859	1947648	1640369	307279	32155	32086	69	54	49	5	2	1672506	307353	90947	52600	38347	1672506	307355	0.020110281865060167	0.0036956493325797147	0	0	0	0	0	0	0	0	0	0	0	0	0	0
2021-01-26	2077459	2043803	1689749	354054	33593	33518	75	61	56	5	2	1723325	354134	97600	50819	46781	1723325	354136	0.02072133163953063	0.004258146026719753	0	0	0	0	0	0	0	0	0	0	0	0	0	0
2021-01-27	2186889	2151434	1738964	412470	35383	35296	87	69	64	5	3	1774327	412562	109430	51002	58428	1774327	412565	0.021334581813629735	0.00496069875842511	0	0	0	0	0	0	0	0	0	0	0	0	0	0
2021-01-28	2279765	2242678	1784163	458515	37012	36837	175	72	67	5	3	1821070	458695	92876	46743	46133	1821070	458698	0.021896621594185685	0.005515403873552244	0	0	0	0	0	0	0	0	0	0	0	0	0	0
2021-01-29	2387717	2349141	1832784	516357	38493	38317	176	80	75	5	3	1871179	516538	107952	50109	57843	1871179	516541	0.02249913429905867	0.0062109105168292635	0	0	0	0	0	0	0	0	0	0	0	0	0	0
2021-01-30	2475946	2436488	1866401	570087	39373	39195	178	82	76	6	3	1905675	570271	88229	34496	53733	1905675	570274	0.022913915641079037	0.006856998348774427	0	0	0	0	0	0	0	0	0	0	0	0	0	0
2021-01-31	2533098	2493258	1891940	601318	39750	39564	186	87	80	7	3	1931587	601511	57152	25912	31240	1931587	601514	0.023225482609261775	0.00723262941106328	0	0	0	0	0	0	0	0	0	0	0	0	0	0
2021-02-01	2652883	2610780	1947916	662864	41962	41773	189	138	131	7	3	1989823	663060	119785	58236	61549	1989823	663063	0.023925714700921624	0.007972697152830777	0	0	0	0	0	0	0	0	0	0	0	0	0	0
2021-02-02	2785405	2740217	2010039	730178	45034	44844	190	151	144	7	3	2055030	730375	132522	65207	67315	2055030	730378	0.02470976638717864	0.00878209551896311	0	0	0	0	0	0	0	0	0	0	0	0	0	0
2021-02-03	2947926	2896381	2068073	828308	51365	51169	196	177	170	7	3	2119415	828511	162521	64385	98136	2119415	828514	0.025483934311169285	0.009962086873917619	0	0	0	0	0	0	0	0	0	0	0	0	0	0
2021-02-04	3082186	3024796	2124186	900610	57205	57006	199	182	175	7	3	2181370	900816	134260	61955	72305	2181370	900819	0.026228883813861535	0.010831485208066002	0	0	0	0	0	0	0	0	0	0	0	0	0	0
2021-02-05	3229499	3165638	2187213	978425	63668	63335	333	190	182	8	3	2250733	978766	147313	69363	77950	2250733	978769	0.02706290741736799	0.011768759257535144	0	0	0	0	0	0	0	0	0	0	0	0	0	0
2021-02-06	3323520	3257028	2230269	1026759	66298	65965	333	191	183	8	3	2296420	1027100	94021	45687	48334	2296420	1027103	0.027612249809902907	0.012349929288414448	0	0	0	0	0	0	0	0	0	0	0	0	0	0
2021-02-07	3377032	3308205	2256347	1051858	68630	68296	334	193	185	8	4	2324832	1052200	53512	28412	25100	2324832	1052204	0.027953876882302102	0.012651744758789368	0	0	0	0	0	0	0	0	0	0	0	0	0	0
2021-02-08	3486138	3413450	2305425	1108025	72461	72125	336	222	214	8	5	2377769	1108369	109106	52937	56169	2377769	1108374	0.028590393577064745	0.013327135180324733	0	0	0	0	0	0	0	0	0	0	0	0	0	0
2021-02-09	3620478	3544239	2362389	1181850	75899	75372	527	335	327	8	5	2438093	1182385	134340	60324	74016	2438093	1182390	0.02931573186776618	0.01421710664979886	0	0	0	0	0	0	0	0	0	0	0	0	0	0
2021-02-10	3775341	3686499	2428363	1258136	80150	78640	1510	8687	8667	20	5	2515675	1259666	154863	77582	77281	2515675	1259671	0.03024858106989466	0.01514633661537968	0	0	0	0	0	0	0	0	0	0	0	0	0	0
2021-02-11	3919416	3806945	2483163	1323782	87431	82883	4548	25033	24999	34	7	2591052	1328364	144075	75377	68698	2591052	1328371	0.031154917260104227	0.01597238827924793	0	0	0	0	0	0	0	0	0	0	0	0	0	0
2021-02-12	4075201	3939133	2544583	1394550	96750	87466	9284	39308	38951	357	10	2671010	1404191	155785	79958	75827	2671010	1404201	0.03211633558528003	0.01688417136034152	0	0	0	0	0	0	0	0	0	0	0	0	0	0
2021-02-13	4182743	4030042	2591545	1438497	100011	89182	10829	52679	52314	365	11	2733052	1449691	107542	62042	45500	2733052	1449702	0.03286233117959901	0.01743127728112273	0	0	0	0	0	0	0	0	0	0	0	0	0	0
2021-02-14	4248012	4085576	2622586	1462990	102489	90455	12034	59935	59549	386	12	2772602	1475410	65269	39550	25719	2772602	1475422	0.033337882028303366	0.017740535633301645	0	0	0	0	0	0	0	0	0	0	0	0	0	0
2021-02-15	4373496	4190306	2674553	1515753	107762	92731	15031	75415	75010	405	13	2842307	1531189	125484	69705	55779	2842307	1531202	0.03417601785406663	0.018411236678579246	0	0	0	0	0	0	0	0	0	0	0	0	0	0
2021-02-16	4507699	4298728	2730096	1568632	113923	95463	18460	95034	94618	416	14	2920191	1587508	134203	77884	56319	2920191	1587522	0.035112498316784466	0.0190884307063676	0	0	0	0	0	0	0	0	0	0	0	0	0	0
2021-02-17	4658784	4421000	2799174	1621826	121937	100288	21649	115832	115403	429	15	3014880	1643904	151085	94689	56396	3014880	1643919	0.03625104280004532	0.01976655058536582	0	0	0	0	0	0	0	0	0	0	0	0	0	0
2021-02-18	4803216	4533311	2861954	1671357	130172	104978	25194	139713	139280	433	20	3106232	1696984	144432	91352	53080	3106232	1697004	0.03734946305619805	0.020404846838298078	0	0	0	0	0	0	0	0	0	0	0	0	0	0
2021-02-19	4961811	4654449	2930530	1723919	140146	111941	28205	167195	166656	539	21	3209148	1752663	158595	102916	55679	3209148	1752684	0.038586929330414424	0.02107434547940702	0	0	0	0	0	0	0	0	0	0	0	0	0	0
2021-02-20	5074105	4741016	2981204	1759812	144616	115977	28639	188451	187902	549	22	3285105	1789000	112294	75957	36337	3285105	1789022	0.03950023946480221	0.021511275106214072	0	0	0	0	0	0	0	0	0	0	0	0	0	0
2021-02-21	5160083	4807633	3019584	1788049	148260	119462	28798	204167	203612	555	23	3342681	1817402	85978	57576	28402	3342681	1817425	0.04019253568894891	0.021852793962238087	0	0	0	0	0	0	0	0	0	0	0	0	0	0
2021-02-22	5315673	4930600	3086463	1844137	157212	126647	30565	227837	227270	567	24	3440404	1875269	155590	97723	57867	3440404	1875293	0.04136756111468686	0.022548601206557273	0	0	0	0	0	0	0	0	0	0	0	0	0	0
2021-02-23	5485932	5064687	3161632	1903055	164444	132223	32221	256776	256199	577	25	3550079	1935853	170259	109675	60584	3550079	1935878	0.04268629788666285	0.0232770777721389	0	0	0	0	0	0	0	0	0	0	0	0	0	0
2021-02-24	5662089	5196482	3235840	1960642	172067	138160	33907	293514	292919	595	26	3666945	1995144	176157	116866	59291	3666945	1995170	0.044091499542407056	0.02399000725181978	0	0	0	0	0	0	0	0	0	0	0	0	0	0
2021-02-25	5851374	5328038	3309879	2018159	178836	143400	35436	344474	343865	609	26	3797170	2054204	189285	130225	59060	3797170	2054230	0.045657330371042325	0.02470014715382937	0	0	0	0	0	0	0	0	0	0	0	0	0	0
2021-02-26	6064724	5469564	3385603	2083961	187686	150635	37051	407448	406767	681	26	3943031	2121693	213350	145861	67489	3943031	2121719	0.04741116911548901	0.025511637703215174	0	0	0	0	0	0	0	0	0	0	0	0	0	0
2021-02-27	6212739	5562415	3439226	2123189	191772	153989	37783	458526	457837	689	26	4051078	2161661	148015	108047	39968	4051078	2161687	0.04871033074759924	0.025992214601344522	0	0	0	0	0	0	0	0	0	0	0	0	0	0
2021-02-28	6315954	5623956	3476924	2147032	195736	157599	38137	496235	495527	708	27	4130077	2185877	103215	78999	24216	4130077	2185904	0.04966021801679761	0.026283400818868503	0	0	0	0	0	0	0	0	0	0	0	0	0	0
2021-03-01	6514457	5754380	3559450	2194930	205373	165215	40158	554677	553953	724	27	4278645	2235812	198503	148568	49935	4278645	2235839	0.05144660584208987	0.026883821340488022	0	0	0	0	0	0	0	0	0	0	0	0	0	0
2021-03-02	6733800	5894735	3650520	2244215	215417	172379	43038	623621	622875	746	27	4445801	2287999	219343	167156	52187	4445801	2288026	0.05345649655425234	0.02751132000398573	0	0	0	0	0	0	0	0	0	0	0	0	0	0
2021-03-03	6981534	6052773	3743802	2308971	230537	181620	48917	698197	697397	800	27	4622846	2358688	247734	177045	70689	4622846	2358715	0.055585293014653425	0.028361287486768593	0	0	0	0	0	0	0	0	0	0	0	0	0	0
2021-03-04	7226745	6194212	3827750	2366462	245025	190713	54312	787481	786644	837	27	4805134	2421611	245211	182288	62923	4805134	2421638	0.05777713152561726	0.029117876261813457	0	0	0	0	0	0	0	0	0	0	0	0	0	0
2021-03-05	7501581	6342434	3914768	2427666	258411	198132	60279	900708	899825	883	28	5012753	2488828	274836	207619	67217	5012753	2488856	0.060273551036543936	0.02992610829590219	0	0	0	0	0	0	0	0	0	0	0	0	0	0
2021-03-06	7704205	6451828	3977689	2474139	267272	204753	62519	985077	984174	903	28	5166644	2537561	202624	153891	48733	5166644	2537589	0.06212394283573388	0.03051207591941444	0	0	0	0	0	0	0	0	0	0	0	0	0	0
2021-03-07	7851960	6531679	4026371	2505308	273937	209076	64861	1046316	1045392	924	28	5280867	2571093	147755	114223	33532	5280867	2571121	0.06349736494930044	0.03091526608524894	0	0	0	0	0	0	0	0	0	0	0	0	0	0
2021-03-08	8089794	6665803	4112231	2553572	284909	216681	68228	1139054	1138089	965	28	5467029	2622765	237834	186162	51672	5467029	2622793	0.06573578459775811	0.031536572367278054	0	0	0	0	0	0	0	0	0	0	0	0	0	0
2021-03-09	8342433	6806128	4201208	2604920	297705	226003	71702	1238572	1237543	1029	28	5664782	2677651	252639	197753	54886	5664782	2677679	0.06811357491340496	0.03219652391928785	0	0	0	0	0	0	0	0	0	0	0	0	0	0
2021-03-10	8631715	6965577	4297034	2668543	309942	234672	75270	1356167	1355086	1081	29	5886821	2744894	289282	222039	67243	5886821	2744923	0.07078338110545215	0.03300506857846044	0	0	0	0	0	0	0	0	0	0	0	0	0	0
2021-03-11	8916318	7113404	4388294	2725110	323680	244056	79624	1479205	1478070	1135	29	6110449	2805869	284603	223628	60975	6110449	2805898	0.07347229349973934	0.03373823452029984	0	0	0	0	0	0	0	0	0	0	0	0	0	0
2021-03-12	9243316	7265217	4473955	2791262	340998	256775	84223	1637072	1635737	1335	29	6366496	2876820	326998	256047	70951	6366496	2876849	0.07655101330146385	0.03459135230200459	0	0	0	0	0	0	0	0	0	0	0	0	0	0
2021-03-13	9484223	7381387	4541230	2840157	350585	265019	85566	1752222	1750775	1447	29	6557053	2927170	240907	190557	50350	6557053	2927199	0.07884227861313405	0.035196762800924035	0	0	0	0	0	0	0	0	0	0	0	0	0	0
2021-03-14	9654473	7469567	4594675	2874892	356105	269562	86543	1828772	1827306	1466	29	6691572	2962901	170250	134519	35731	6691572	2962930	0.0804597406767715	0.03562639383442733	0	0	0	0	0	0	0	0	0	0	0	0	0	0
2021-03-15	9902742	7622625	4690204	2932421	368794	280551	88243	1911294	1909762	1532	29	6880546	3022196	248269	188974	59295	6880546	3022225	0.08273197193045184	0.036339359386233276	0	0	0	0	0	0	0	0	0	0	0	0	0	0
2021-03-16	10081898	7789475	4791237	2998238	380082	289350	90732	1912312	1910777	1535	29	6991393	3090505	179156	110847	68309	6991393	3090534	0.0840648008792845	0.03716070964980207	0	0	0	0	0	0	0	0	0	0	0	0	0	0
2021-03-17	10287240	7976047	4901558	3074489	398106	302562	95544	1913058	1911518	1540	29	7115667	3171573	205342	124274	81068	7115667	3171602	0.08555907663584292	0.03813547466124998	0	0	0	0	0	0	0	0	0	0	0	0	0	0
2021-03-18	10481102	8150527	5005568	3144959	416327	315550	100777	1914219	1912678	1541	29	7233825	3247277	193862	118158	75704	7233825	3247306	0.08697981335344619	0.03904574271309106	0	0	0	0	0	0	0	0	0	0	0	0	0	0
2021-03-19	10726541	8336468	5113934	3222534	437191	329558	107633	1952853	1951255	1598	29	7394776	3331765	245439	160951	84488	7394776	3331794	0.08891509488694341	0.04006162994710708	0	0	0	0	0	0	0	0	0	0	0	0	0	0
2021-03-20	10946996	8471992	5199989	3272003	452507	341043	111464	2022468	2020840	1628	29	7561901	3385095	220455	167125	53330	7561901	3385124	0.09092461285381359	0.040702872090252556	0	0	0	0	0	0	0	0	0	0	0	0	0	0
2021-03-21	11111747	8574334	5267345	3306989	461718	347007	114711	2075666	2074013	1653	29	7688394	3423353	164751	126493	38258	7688394	3423382	0.09244556995887453	0.04116288787709785	0	0	0	0	0	0	0	0	0	0	0	0	0	0
2021-03-22	11381438	8741017	5364963	3376054	485596	363470	122126	2154796	2153092	1704	29	7881554	3499884	269691	193160	76531	7881554	3499913	0.0947681338510549	0.04208309981141373	0	0	0	0	0	0	0	0	0	0	0	0	0	0
2021-03-23	11682825	8922957	5467772	3455185	505354	378245	127109	2254485	2252725	1760	29	8098771	3584054	301387	217217	84170	8098771	3584083	0.09737996011408939	0.04309516340017342	0	0	0	0	0	0	0	0	0	0	0	0	0	0
2021-03-24	12022399	9123336	5584060	3539276	538475	406054	132421	2360558	2358726	1832	30	8348870	3673529	339574	250099	89475	8348870	3673559	0.10038716091586211	0.04417102655412212	0	0	0	0	0	0	0	0	0	0	0	0	0	0
2021-03-25	12355521	9309109	5694266	3614843	566160	428162	137998	2480222	2478279	1943	30	8600737	3754784	333122	251867	81255	8600737	3754814	0.10341562022333671	0.04514804006136542	0	0	0	0	0	0	0	0	0	0	0	0	0	0
2021-03-26	12730213	9509103	5812417	3696686	603463	458649	144814	2617616	2615574	2042	31	8886671	3843542	374692	285934	88758	8886671	3843573	0.10685370255894813	0.04621528197742484	0	0	0	0	0	0	0	0	0	0	0	0	0	0
2021-03-27	13011894	9658845	5902934	3755911	631131	483201	147930	2721886	2719786	2100	32	9105953	3905941	281681	219282	62399	9105953	3905973	0.10949035846806543	0.046965582178667614	0	0	0	0	0	0	0	0	0	0	0	0	0	0
2021-03-28	13208540	9774317	5968451	3805866	649674	498463	151211	2784517	2782366	2151	32	9249312	3959228	196646	143359	53287	9249312	3959260	0.11121411306021228	0.047606307288020566	0	0	0	0	0	0	0	0	0	0	0	0	0	0
2021-03-29	13514552	9963192	6075509	3887683	674713	516682	158031	2876615	2874401	2214	32	9466624	4047928	306012	217312	88700	9466624	4047960	0.113827081607207	0.048672839785620474	0	0	0	0	0	0	0	0	0	0	0	0	0	0
2021-03-30	13843874	10182006	6208211	3973795	699201	534679	164522	2962635	2960362	2273	32	9703284	4140590	329322	236660	92662	9703284	4140622	0.11667269131275373	0.049787011536382625	0	0	0	0	0	0	0	0	0	0	0	0	0	0
2021-03-31	14180674	10429915	6362500	4067415	735342	562779	172563	3015385	3013076	2309	32	9938387	4242287	336800	235103	101697	9938387	4242319	0.11949957958539445	0.05100982050378306	0	0	0	0	0	0	0	0	0	0	0	0	0	0
2021-04-01	14507895	10669262	6518867	4150395	767833	587371	180462	3070768	3068417	2351	32	10174687	4333208	327221	236300	90921	10174687	4333240	0.12234086063593401	0.05210305839796887	0	0	0	0	0	0	0	0	0	0	0	0	0	0
2021-04-02	14733923	10849032	6634930	4214102	782241	597430	184811	3102618	3100241	2377	32	10332633	4401290	226028	157946	68082	10332633	4401322	0.12424000992416305	0.05292167920407481	0	0	0	0	0	0	0	0	0	0	0	0	0	0
2021-04-03	14966136	11023450	6749728	4273722	798051	608390	189661	3144603	3142188	2415	32	10500338	4465798	232213	167705	64508	10500338	4465830	0.12625650183521145	0.05369732608519291	0	0	0	0	0	0	0	0	0	0	0	0	0	0
2021-04-04	15159330	11155826	6835625	4320201	808122	614569	193553	3195350	3192892	2458	32	10643118	4516212	193194	142780	50414	10643118	4516244	0.12797329450722175	0.0543035061227803	0	0	0	0	0	0	0	0	0	0	0	0	0	0
2021-04-05	15407559	11321071	6935380	4385691	826005	627666	198339	3260451	3257961	2490	32	10821039	4586520	248229	177921	70308	10821039	4586552	0.1301126240281403	0.05514889244568058	0	0	0	0	0	0	0	0	0	0	0	0	0	0
2021-04-06	15781724	11576300	7104528	4471772	858220	651188	207032	3347170	3344611	2559	34	11100361	4681363	374165	279322	94843	11100361	4681397	0.13347120340012003	0.05628931267944454	0	0	0	0	0	0	0	0	0	0	0	0	0	0
2021-04-07	16450193	12118791	7559234	4559557	895325	679660	215665	3436043	3433402	2641	34	11672330	4777863	668469	571969	96500	11672330	4777897	0.1403485824995532	0.0574496327021998	0	0	0	0	0	0	0	0	0	0	0	0	0	0
2021-04-08	17149504	12690612	8052338	4638274	930994	706349	224645	3527864	3525142	2722	34	12283863	4865641	699311	611533	87778	12283863	4865675	0.14770168078427437	0.05850507903336468	0	0	0	0	0	0	0	0	0	0	0	0	0	0
2021-04-09	17782371	13181495	8465702	4715793	967723	731623	236100	3633119	3630314	2805	34	12827673	4954698	632867	543810	89057	12827673	4954732	0.15424047489385506	0.0595759041138467	0	0	0	0	0	0	0	0	0	0	0	0	0	0
2021-04-10	18155343	13430197	8657041	4773156	990981	747192	243789	3734131	3731263	2868	34	13135530	5019813	372972	307857	65115	13135530	5019847	0.15794216029536146	0.06035884958826856	0	0	0	0	0	0	0	0	0	0	0	0	0	0
2021-04-11	18419562	13600757	8781240	4819517	1009673	761935	247738	3809098	3806155	2943	34	13349364	5070198	264219	213834	50385	13349364	5070232	0.16051330922537024	0.06096468092864704	0	0	0	0	0	0	0	0	0	0	0	0	0	0
2021-04-12	18838560	13879928	8992491	4887437	1038954	782732	256222	3919643	3916648	2995	35	13691906	5146654	418998	342542	76456	13691906	5146689	0.16463204851277574	0.06188400308387811	0	0	0	0	0	0	0	0	0	0	0	0	0	0
2021-04-13	19415800	14312350	9356790	4955560	1066311	804643	261668	4037104	4033915	3189	35	14195383	5220417	577240	503477	73763	14195383	5220452	0.1706858769490115	0.06277093247080553	0	0	0	0	0	0	0	0	0	0	0	0	0	0
2021-04-14	20191374	14929234	9899469	5029765	1099911	829729	270182	4162194	4158447	3747	35	14887680	5303694	775574	692297	83277	14887680	5303729	0.17901008493650783	0.06377225859033911	0	0	0	0	0	0	0	0	0	0	0	0	0	0
2021-04-15	20872118	15463751	10373166	5090585	1136045	857242	278803	4272286	4267598	4688	36	15498042	5374076	680744	610362	70382	15498042	5374112	0.18634910306841398	0.06461854671636588	0	0	0	0	0	0	0	0	0	0	0	0	0	0
2021-04-16	21469116	15902285	10746670	5155615	1168560	881311	287249	4398235	4392743	5492	36	16020760	5448356	596998	522718	74280	16020760	5448392	0.1926342860907413	0.06551169253284526	0	0	0	0	0	0	0	0	0	0	0	0	0	0
2021-04-17	21835499	16127376	10923719	5203657	1191276	896878	294398	4516811	4509837	6974	36	16330470	5505029	366383	309710	56673	16330470	5505065	0.1963582520414929	0.06619313104734897	0	0	0	0	0	0	0	0	0	0	0	0	0	0
2021-04-18	22105309	16299591	11061959	5237632	1206687	908383	298304	4598995	4590853	8142	36	16561231	5544078	269810	230761	39049	16561231	5544114	0.19913293192513049	0.06666265785116836	0	0	0	0	0	0	0	0	0	0	0	0	0	0
2021-04-19	22507887	16593625	11303765	5289860	1239675	933423	306252	4674550	4665088	9462	37	16902313	5605574	402578	341082	61496	16902313	5605611	0.20323411611167358	0.06740210034276815	0	0	0	0	0	0	0	0	0	0	0	0	0	0
2021-04-20	23069003	16975826	11631878	5343948	1278972	966040	312932	4814167	4802623	11544	38	17400579	5668424	561116	498266	62850	17400579	5668462	0.20922528726668055	0.06815782338681158	0	0	0	0	0	0	0	0	0	0	0	0	0	0
2021-04-21	23790659	17430599	12023998	5406601	1320728	999652	321076	5039294	5025298	13996	38	18048986	5741673	721656	648407	73249	18048986	5741711	0.21702176006455276	0.0690385724163121	0	0	0	0	0	0	0	0	0	0	0	0	0	0
2021-04-22	24429669	17812648	12350049	5462599	1364450	1035684	328766	5252533	5234909	17624	38	18620680	5808989	639010	571694	67316	18620680	5809027	0.22389583255252213	0.06984798280648612	0	0	0	0	0	0	0	0	0	0	0	0	0	0
2021-04-23	24986455	18166231	12648710	5517521	1408096	1068795	339301	5412090	5390913	21177	38	19108456	5877999	556786	487776	69010	19108456	5878037	0.22976087151023683	0.07067776192327721	0	0	0	0	0	0	0	0	0	0	0	0	0	0
2021-04-24	25352456	18401469	12842675	5558794	1457498	1102796	354702	5493451	5469920	23531	38	19415429	5937027	366001	306973	59028	19415429	5937065	0.23345192765889228	0.07138751705595284	0	0	0	0	0	0	0	0	0	0	0	0	0	0
2021-04-25	25635742	18589449	12993220	5596229	1491219	1126633	364586	5555036	5529716	25320	38	19649607	5986135	283286	234178	49108	19649607	5986173	0.2362676936929729	0.07197799369509755	0	0	0	0	0	0	0	0	0	0	0	0	0	0
2021-04-26	26069126	18907579	13249744	5657835	1533774	1160776	372998	5627665	5598339	29326	108	20008967	6060159	433384	359360	74024	20008967	6060267	0.24058865331346335	0.07286890303982323	0	0	0	0	0	0	0	0	0	0	0	0	0	0
2021-04-27	26854951	19584564	13848800	5735764	1585341	1203206	382135	5684385	5650572	33813	661	20703239	6151712	785825	694272	91553	20703239	6152373	0.2489366087832907	0.07397638942340765	0	0	0	0	0	0	0	0	0	0	0	0	0	0
2021-04-28	27978645	20593064	14748607	5844457	1646143	1251452	394691	5737944	5699010	38934	1494	21700563	6278082	1123694	997324	126370	21700563	6279576	0.2609284741343204	0.07550588359806606	0	0	0	0	0	0	0	0	0	0	0	0	0	0
2021-04-29	28925695	21418019	15461147	5956872	1710134	1303033	407101	5795136	5748296	46840	2406	22514882	6410813	947050	814319	132731	22514882	6413219	0.27071987973649697	0.07711281260118606	0	0	0	0	0	0	0	0	0	0	0	0	0	0
2021-04-30	29730164	22096911	16028389	6068522	1767479	1345107	422372	5862468	5806227	56241	3306	23183029	6547135	804469	668147	136322	23183029	6550441	0.27875370711726233	0.07876277564950236	0	0	0	0	0	0	0	0	0	0	0	0	0	0
2021-05-01	30066776	22349977	16220148	6129829	1809016	1380232	428784	5901903	5839638	62265	5880	23445898	6620878	336612	262869	73743	23445898	6626758	0.28191445493137274	0.07968041443889731	0	0	0	0	0	0	0	0	0	0	0	0	0	0
2021-05-02	30332009	22545725	16360112	6185613	1846564	1412518	434046	5932032	5865183	66849	7688	23645501	6686508	265233	199603	65630	23645501	6694196	0.28431448972413975	0.0804912917621571	0	0	0	0	0	0	0	0	0	0	0	0	0	0
2021-05-03	30784057	22863841	16587132	6276709	1917204	1469936	447268	5993734	5916270	77464	9278	23982616	6801441	452048	337115	114933	23982616	6810719	0.28836797453731217	0.08189236917160281	0	0	0	0	0	0	0	0	0	0	0	0	0	0
2021-05-04	31627410	23490420	17081812	6408608	1980736	1520218	460518	6144013	6052829	91184	12241	24667100	6960310	843353	684484	158869	24667100	6972551	0.2965982386871112	0.0838382438858259	0	0	0	0	0	0	0	0	0	0	0	0	0	0
2021-05-05	32775166	24342192	17747879	6594313	2059735	1573695	486040	6356523	6248433	108090	16716	25586723	7188443	1147756	919623	228133	25586723	7205159	0.30765582397505176	0.0866351321744586	0	0	0	0	0	0	0	0	0	0	0	0	0	0
2021-05-06	33766860	25035526	18263628	6771898	2151960	1643448	508512	6558105	6430539	127566	21269	26358884	7407976	991694	772161	219533	26358884	7429245	0.31694032002780537	0.08932955157983824	0	0	0	0	0	0	0	0	0	0	0	0	0	0
2021-05-07	34658747	25623913	18677857	6946056	2238708	1699197	539511	6770654	6613784	156870	25472	27016310	7642437	891887	657426	234461	27016310	7667909	0.3248452376576489	0.09219925746492488	0	0	0	0	0	0	0	0	0	0	0	0	0	0
2021-05-08	35085044	25891877	18832797	7059080	2310634	1751212	559422	6855343	6678827	176516	27190	27290026	7795018	426297	273716	152581	27290026	7822208	0.32813641025193363	0.09405455507312295	0	0	0	0	0	0	0	0	0	0	0	0	0	0
2021-05-09	35371504	26085963	18947541	7138422	2367236	1797014	570222	6890047	6702101	187946	28258	27474914	7896590	286460	184888	101572	27474914	7924848	0.33035951127128255	0.09528870271183383	0	0	0	0	0	0	0	0	0	0	0	0	0	0
2021-05-10	35961187	26459363	19178994	7280369	2449108	1856679	592429	7020728	6806938	213790	31988	27874599	8086588	589683	399685	189998	27874599	8118576	0.3351653403727845	0.09761809625969217	0	0	0	0	0	0	0	0	0	0	0	0	0	0
2021-05-11	37047450	27285588	19772194	7513394	2529131	1914455	614676	7197100	6954168	242932	35631	28676448	8371002	1086263	801849	284414	28676448	8406633	0.3448068061751294	0.10108170563580421	0	0	0	0	0	0	0	0	0	0	0	0	0	0
2021-05-12	38464155	28379496	20569428	7810068	2620870	1975621	645249	7422403	7145484	276919	41386	29731919	8732236	1416705	1055471	361234	29731919	8773622	0.3574978334781088	0.10549439667032161	0	0	0	0	0	0	0	0	0	0	0	0	0	0
2021-05-13	38893663	28695028	20757056	7937972	2687653	2027190	660463	7466946	7174787	292159	44036	30003069	8890594	429508	271150	158358	30003069	8934630	0.3607581523814258	0.10743036357419497	0	0	0	0	0	0	0	0	0	0	0	0	0	0
2021-05-14	39650610	29240590	21121951	8118639	2752598	2076940	675658	7605589	7286445	319144	51833	30537169	9113441	756947	534100	222847	30537169	9165274	0.3671801930462298	0.11020363664495522	0	0	0	0	0	0	0	0	0	0	0	0	0	0
2021-05-15	40051263	29520051	21278875	8241176	2813032	2120923	692109	7662065	7320370	341695	56115	30776283	9274980	400653	239114	161539	30776283	9331095	0.3700553097500754	0.11219747526146609	0	0	0	0	0	0	0	0	0	0	0	0	0	0
2021-05-16	40333649	29719996	21385355	8334641	2865801	2163796	702005	7687011	7331685	355326	60841	30941677	9391972	282386	165394	116992	30941677	9452813	0.3720440141007861	0.1136610175674736	0	0	0	0	0	0	0	0	0	0	0	0	0	0
2021-05-17	40889152	30058491	21578354	8480137	2951516	2225067	726449	7808542	7426846	381696	70603	31300870	9588282	555503	359193	196310	31300870	9658885	0.3763629657063149	0.11613883588591113	0	0	0	0	0	0	0	0	0	0	0	0	0	0
2021-05-18	41761471	30648308	21877849	8770459	3052688	2297626	755062	7982098	7572335	409763	78377	31826187	9935284	872319	525317	347002	31826187	10013661	0.3826793992129856	0.1204046772993103	0	0	0	0	0	0	0	0	0	0	0	0	0	0
2021-05-19	42859957	31452822	22221956	9230866	3152983	2364025	788958	8163610	7725867	437743	90542	32402390	10457567	1098486	576203	522283	32402390	10548109	0.38960768810491975	0.1268309023306212	0	0	0	0	0	0	0	0	0	0	0	0	0	0
2021-05-20	43807984	32136846	22482990	9653856	3249502	2429572	819930	8320252	7855026	465226	101384	32868972	10939012	948027	466582	481445	32868972	11040396	0.39521788952312903	0.13275018174038408	0	0	0	0	0	0	0	0	0	0	0	0	0	0
2021-05-21	44659654	32733453	22705641	10027812	3335246	2485972	849274	8477688	7982161	495527	113267	33287041	11372613	851670	418069	433601	33287041	11485880	0.4002447686069971	0.13810669992708982	0	0	0	0	0	0	0	0	0	0	0	0	0	0
2021-05-22	45133886	33039960	22804251	10235709	3404822	2534320	870502	8561550	8050302	511248	127554	33516427	11617459	474232	229386	244846	33516427	11745013	0.4030029154333156	0.14122252592145912	0	0	0	0	0	0	0	0	0	0	0	0	0	0
2021-05-23	45419221	33233050	22869971	10363079	3464272	2578646	885626	8585477	8065104	520373	136422	33650143	11769078	285335	133716	151619	33650143	11905500	0.40461072219147876	0.14315222829961377	0	0	0	0	0	0	0	0	0	0	0	0	0	0
2021-05-24	45745416	33468965	22952630	10516335	3525844	2625211	900633	8606141	8077085	529056	144466	33799392	11946024	326195	149249	176946	33799392	12090490	0.40640529838915956	0.14537655577121475	0	0	0	0	0	0	0	0	0	0	0	0	0	0
2021-05-25	46401359	33915852	23094366	10821486	3605661	2676683	928978	8710219	8156073	554146	169627	34096749	12304610	655943	297357	358586	34096749	12474237	0.4099807313529568	0.14999074569631593	0	0	0	0	0	0	0	0	0	0	0	0	0	0
2021-05-26	47581625	34801288	23409338	11391950	3688085	2729308	958777	8844351	8258208	586143	247901	34644755	12936870	1180266	548006	632260	34644755	13184771	0.4165699783414544	0.15853423613205048	0	0	0	0	0	0	0	0	0	0	0	0	0	0
2021-05-27	48622962	35540796	23667287	11873509	3777102	2780980	996122	8976040	8352913	623127	329024	35130204	13492758	1041337	485449	555888	35130204	13821782	0.42240703735416446	0.1661936829508624	0	0	0	0	0	0	0	0	0	0	0	0	0	0
2021-05-28	49527597	36144758	23884230	12260528	3863327	2831534	1031793	9106626	8441951	664675	412886	35570601	13956996	904635	440397	464238	35570601	14369882	0.42770238924081055	0.17278406019927853	0	0	0	0	0	0	0	0	0	0	0	0	0	0
2021-05-29	49938402	36407114	23964288	12442826	3925974	2868409	1057565	9164634	8477004	687630	440680	35750381	14188021	410805	179780	231025	35750381	14628701	0.42986407145522443	0.17589611064455826	0	0	0	0	0	0	0	0	0	0	0	0	0	0
2021-05-30	50222178	36604425	24023547	12580878	3973032	2895783	1077249	9193008	8488172	704836	451713	35859215	14362963	283776	108834	174942	35859215	14814676	0.431172696008142	0.17813228179722052	0	0	0	0	0	0	0	0	0	0	0	0	0	0
2021-05-31	50769503	36972051	24135389	12836662	4040536	2923488	1117048	9262720	8527131	735589	494196	36080204	14689299	547325	220989	326336	36080204	15183495	0.4338298769564183	0.18256697682802436	0	0	0	0	0	0	0	0	0	0	0	0	0	0
2021-06-01	51758541	37706039	24451682	13254357	4120410	2953260	1167150	9353334	8581287	772047	578758	36564987	15193554	989038	484783	504255	36564987	15772312	0.43965892795736505	0.1896469369817931	0	0	0	0	0	0	0	0	0	0	0	0	0	0
2021-06-02	53007865	38695524	24901230	13794294	4193059	2977754	1215305	9435659	8624273	811386	683623	37186880	15820985	1249324	621893	627431	37186880	16504608	0.4471365953139592	0.1984520946127111	0	0	0	0	0	0	0	0	0	0	0	0	0	0
2021-06-03	53651094	39170914	25081189	14089725	4257423	3007490	1249933	9485925	8645139	840786	736832	37470650	16180444	643229	283770	359459	37470650	16917276	0.4505486576233609	0.20341403184742993	0	0	0	0	0	0	0	0	0	0	0	0	0	0
2021-06-04	54462916	39757226	25309553	14447673	4328740	3036222	1292518	9562897	8679655	883242	814053	37839483	16623433	811822	368833	442989	37839483	17437486	0.45498352099074835	0.20966905857320725	0	0	0	0	0	0	0	0	0	0	0	0	0	0
2021-06-05	54876175	40028572	25368729	14659843	4395778	3062531	1333247	9607160	8690586	916574	844665	37966511	16909664	413259	127028	286231	37966511	17754329	0.4565109109581116	0.21347879201330927	0	0	0	0	0	0	0	0	0	0	0	0	0	0
2021-06-06	55168665	40234504	25412716	14821788	4436818	3074513	1362305	9634432	8694136	940296	862911	38044276	17124389	292490	77765	214725	38044276	17987300	0.45744596055986875	0.2162800450290742	0	0	0	0	0	0	0	0	0	0	0	0	0	0
2021-06-07	55782953	40636560	25546854	15089706	4521979	3102098	1419881	9707020	8725301	981719	917394	38291647	17491306	614288	247371	366917	38291647	18408700	0.46042035977592044	0.22134697619580027	0	0	0	0	0	0	0	0	0	0	0	0	0	0
2021-06-08	56838184	41485009	25831149	15653860	4597431	3128349	1469082	9769994	8757609	1012385	985750	38702857	18135327	1055231	411210	644021	38702857	19121077	0.46536476595786025	0.22991262694036319	0	0	0	0	0	0	0	0	0	0	0	0	0	0
2021-06-09	58263254	42662920	26220224	16442696	4684754	3156784	1527970	9834049	8790032	1044017	1081531	39248571	19014683	1425070	545714	879356	39248571	20096214	0.4719264538428122	0.24163771487849267	0	0	0	0	0	0	0	0	0	0	0	0	0	0
2021-06-10	59456114	43621642	26567167	17054475	4774619	3188832	1585787	9889874	8816953	1072921	1169979	39742931	19713183	1192860	494360	698500	39742931	20883162	0.47787065909099136	0.25110001043566577	0	0	0	0	0	0	0	0	0	0	0	0	0	0
2021-06-11	60520384	44430829	26874997	17555832	4863751	3217073	1646678	9959046	8846579	1112467	1266758	40205407	20314977	1064270	462476	601794	40205407	21581735	0.4834314897940355	0.25949968130878714	0	0	0	0	0	0	0	0	0	0	0	0	0	0
2021-06-12	60956323	44716073	26967244	17748829	4935734	3235813	1699921	10002518	8859726	1142792	1301998	40364781	20591542	435939	159374	276565	40364781	21893540	0.48534780941379296	0.2632488376268721	0	0	0	0	0	0	0	0	0	0	0	0	0	0
2021-06-13	61239506	44896069	27011443	17884626	4999305	3251760	1747545	10028342	8864366	1163976	1315790	40443359	20796147	283183	78578	204605	40443359	22111937	0.4862926345614413	0.2658748522590968	0	0	0	0	0	0	0	0	0	0	0	0	0	0
2021-06-14	61895620	45328048	27184966	18143082	5100719	3275407	1825312	10095825	8882007	1213818	1371028	40713408	21182212	656114	270049	386065	40713408	22553240	0.4895397149948613	0.27118109792751094	0	0	0	0	0	0	0	0	0	0	0	0	0	0
2021-06-15	62943518	46127458	27484317	18643141	5205462	3303968	1901494	10180485	8901682	1278803	1430113	41120080	21823438	1047898	406672	641226	41120080	23253551	0.49442955607562744	0.27960166658508356	0	0	0	0	0	0	0	0	0	0	0	0	0	0
2021-06-16	64326998	47231275	27893299	19337976	5312083	3336399	1975684	10277239	8927250	1349989	1506401	41663349	22663649	1383480	543269	840211	41663349	24170050	0.5009618451786557	0.29062168876679517	0	0	0	0	0	0	0	0	0	0	0	0	0	0
2021-06-17	65475403	48115488	28241146	19874342	5415752	3366149	2049603	10369491	8949562	1419929	1574672	42131529	23343874	1148405	468180	680225	42131529	24918546	0.5065912610154801	0.2996216358730358	0	0	0	0	0	0	0	0	0	0	0	0	0	0
2021-06-18	66468661	48849000	28533643	20315357	5510276	3397454	2112822	10465863	8971652	1494211	1643522	42546271	23922390	993258	414742	578516	42546271	25565912	0.5115781361126569	0.3074055916435123	0	0	0	0	0	0	0	0	0	0	0	0	0	0
2021-06-19	66896064	49122130	28625898	20496232	5592437	3418451	2173986	10516832	8978204	1538628	1664665	42687218	24208846	427403	140947	286456	42687218	25873511	0.5132728887162558	0.3111041748422635	0	0	0	0	0	0	0	0	0	0	0	0	0	0
2021-06-20	67191366	49301107	28675208	20625899	5664084	3434491	2229593	10548696	8980825	1567871	1677479	42768003	24423363	295302	80785	214517	42768003	26100842	0.5142442509239064	0.3138376122629161	0	0	0	0	0	0	0	0	0	0	0	0	0	0
2021-06-21	67822867	49712936	28846023	20866913	5761838	3459598	2302240	10634264	8994825	1639439	1713829	43014275	24808592	631501	246272	385229	43014275	26522421	0.5172054357181445	0.3189066957331041	0	0	0	0	0	0	0	0	0	0	0	0	0	0
2021-06-22	68899973	50557085	29174715	21382370	5857944	3490343	2367601	10736964	9011067	1725897	1747980	43424105	25475868	1077106	409830	667276	43424105	27223848	0.5221332487225568	0.3273406832211989	0	0	0	0	0	0	0	0	0	0	0	0	0	0
2021-06-23	70235437	51646131	29612786	22033345	5954153	3520461	2433692	10852634	9031749	1820885	1782519	43947515	26287922	1335464	523410	812054	43947515	28070441	0.5284267523817312	0.33752015274476826	0	0	0	0	0	0	0	0	0	0	0	0	0	0
2021-06-24	71271049	52443267	30045447	22397820	6041551	3555885	2485666	10963412	9053011	1910401	1822819	44477162	26793887	1035612	529647	505965	44477162	28616706	0.5347952499889048	0.3440884658766895	0	0	0	0	0	0	0	0	0	0	0	0	0	0
2021-06-25	72192190	53137624	30379588	22758036	6118178	3582729	2535449	11073374	9072900	2000474	1863014	44898231	27293959	921141	421069	500072	44898231	29156973	0.5398582011978327	0.3505846588065747	0	0	0	0	0	0	0	0	0	0	0	0	0	0
2021-06-26	72602297	53392769	30484593	22908176	6187289	3608360	2578929	11145963	9079206	2066757	1876276	45048435	27553862	410107	150204	259903	45048435	29430138	0.5416642603553241	0.3538692061538901	0	0	0	0	0	0	0	0	0	0	0	0	0	0
2021-06-27	72894320	53565734	30551873	23013861	6245441	3627687	2617754	11202748	9082612	2120136	1880397	45142569	27751751	292023	94134	197889	45142569	29632148	0.5427961314954489	0.35629818281499676	0	0	0	0	0	0	0	0	0	0	0	0	0	0
2021-06-28	73523765	53966890	30749991	23216899	6335521	3660134	2675387	11316559	9096370	2220189	1904795	45411290	28112475	629445	268721	360724	45411290	30017270	0.5460272440015093	0.36092890579741693	0	0	0	0	0	0	0	0	0	0	0	0	0	0
2021-06-29	74457027	54651874	31094693	23557181	6428544	3693198	2735346	11449375	9108131	2341244	1927234	45823256	28633771	933262	411966	521296	45823256	30561005	0.550980740358964	0.3674667981038712	0	0	0	0	0	0	0	0	0	0	0	0	0	0
2021-06-30	75480188	55421473	31497267	23924206	6522720	3728051	2794669	11586036	9122650	2463386	1949959	46297927	29182261	1023161	474671	548490	46297927	31132220	0.5566882042503761	0.37433511107587264	0	0	0	0	0	0	0	0	0	0	0	0	0	0
2021-07-01	76463252	56165458	31906525	24258933	6606294	3758673	2847621	11718883	9136192	2582691	1972617	46774007	29689245	983064	476080	506984	46774007	31661862	0.5624126100165245	0.38070354856283783	0	0	0	0	0	0	0	0	0	0	0	0	0	0
2021-07-02	77310631	56816376	32246093	24570283	6701334	3790503	2910831	11798129	9145419	2652710	1994792	47176807	30133824	847379	402800	444579	47176807	32128616	0.5672558940078801	0.3863158181162172	0	0	0	0	0	0	0	0	0	0	0	0	0	0
2021-07-03	77688326	57072323	32368130	24704193	6780717	3815186	2965531	11825280	9148226	2677054	2010006	47341548	30346778	377695	164741	212954	47341548	32356784	0.5692367466593695	0.3890593196597615	0	0	0	0	0	0	0	0	0	0	0	0	0	0
2021-07-04	77961788	57254140	32441373	24812767	6848906	3833675	3015231	11839816	9149684	2690132	2018926	47443658	30518130	273462	102110	171352	47443658	32537056	0.5704645215559865	0.39122691770268514	0	0	0	0	0	0	0	0	0	0	0	0	0	0
2021-07-05	78498787	57642123	32607977	25034146	6943484	3859964	3083520	11879398	9154067	2725331	2033782	47655790	30842997	536999	212132	324867	47655790	32876779	0.5730152055670448	0.3953117612165762	0	0	0	0	0	0	0	0	0	0	0	0	0	0
2021-07-06	79277733	58260693	32849122	25411571	7042843	3885365	3157478	11924720	9158697	2766023	2049477	47942661	31335072	778946	286871	492075	47942661	33384549	0.5764645544297164	0.4014172088637724	0	0	0	0	0	0	0	0	0	0	0	0	0	0
2021-07-07	80274861	59091328	33143834	25947494	7138861	3910105	3228756	11976086	9164111	2811975	2068586	48286636	31988225	997128	343975	653153	48286636	34056811	0.5806005241688589	0.4095005151760781	0	0	0	0	0	0	0	0	0	0	0	0	0	0
2021-07-08	81123739	59776569	33380983	26395586	7240430	3932711	3307719	12018721	9168398	2850323	2088019	48570111	32553628	848878	283475	565403	48570111	34641647	0.5840090393859629	0.4165326076198925	0	0	0	0	0	0	0	0	0	0	0	0	0	0
2021-07-09	81882434	60372393	33578942	26793451	7339444	3950707	3388737	12061932	9172842	2889090	2108665	48811156	33071278	758695	241045	517650	48811156	35179943	0.5869073745143054	0.4230051011636134	0	0	0	0	0	0	0	0	0	0	0	0	0	0
2021-07-10	82226294	60601055	33655512	26945543	7423736	3968951	3454785	12083058	9174288	2908770	2118445	48917196	33309098	343860	106040	237820	48917196	35427543	0.5881824038947506	0.4259822538852114	0	0	0	0	0	0	0	0	0	0	0	0	0	0
2021-07-11	82454524	60747055	33701553	27045502	7487380	3983841	3503539	12093349	9174759	2918590	2126740	48986893	33467631	228230	69697	158533	48986893	35594371	0.5890204435281804	0.42798820071170063	0	0	0	0	0	0	0	0	0	0	0	0	0	0
2021-07-12	82923245	61098043	33822392	27275651	7566971	4012935	3554036	12117385	9176633	2940752	2140846	49152806	33770439	468721	165913	302808	49152806	35911285	0.5910153883565264	0.43179878785876236	0	0	0	0	0	0	0	0	0	0	0	0	0	0
2021-07-13	83685646	61727865	33974775	27753090	7644995	4039048	3605947	12152000	9178897	2973103	2160786	49353506	34332140	762401	200700	561701	49353506	36492926	0.5934286135230237	0.4387924634893882	0	0	0	0	0	0	0	0	0	0	0	0	0	0
2021-07-14	84661563	62561526	34153697	28407829	7717142	4060387	3656755	12199146	9182568	3016578	2183749	49580401	35081162	975917	226895	749022	49580401	37264911	0.5961568084615009	0.448074843310805	0	0	0	0	0	0	0	0	0	0	0	0	0	0
2021-07-15	85429319	63196929	34302935	28893994	7788322	4079677	3708645	12237717	9185446	3052271	2206351	49774409	35654910	767756	194008	573748	49774409	37861261	0.5984895687410315	0.4552453805705987	0	0	0	0	0	0	0	0	0	0	0	0	0	0
2021-07-16	86090025	63738926	34435808	29303118	7852826	4096978	3755848	12269687	9187371	3082316	2228586	49948743	36141282	660706	174334	486372	49948743	38369868	0.6005857680244202	0.46136089234068667	0	0	0	0	0	0	0	0	0	0	0	0	0	0
2021-07-17	86361982	63913407	34490392	29423015	7916071	4112771	3803300	12285341	9188257	3097084	2247163	50038583	36323399	271957	89840	182117	50038583	38570562	0.6016660079295428	0.4637740453629337	0	0	0	0	0	0	0	0	0	0	0	0	0	0
2021-07-18	86562049	64049171	34540641	29508530	7957667	4122097	3835570	12296799	9188534	3108265	2258412	50109684	36452365	200067	71101	128966	50109684	38710777	0.6025209293175006	0.465459996368018	0	0	0	0	0	0	0	0	0	0	0	0	0	0
2021-07-19	86943584	64345960	34618320	29727640	8008374	4135092	3873282	12316598	9189867	3126731	2272652	50215931	36727653	381535	106247	275288	50215931	39000305	0.603798447674575	0.468941293109451	0	0	0	0	0	0	0	0	0	0	0	0	0	0
2021-07-20	87550087	64867636	34726859	30140777	8056950	4150857	3906093	12338529	9192396	3146133	2286972	50357084	37193003	606503	141153	465350	50357084	39479975	0.6054956772307613	0.47470886518525424	0	0	0	0	0	0	0	0	0	0	0	0	0	0
2021-07-21	88305464	65540216	34867736	30672480	8103076	4163902	3939174	12361317	9193996	3167321	2300855	50526489	37778975	755377	169405	585972	50526489	40079830	0.6075326100126768	0.48192154671115944	0	0	0	0	0	0	0	0	0	0	0	0	0	0
2021-07-22	88926826	66085698	34977932	31107766	8146530	4174037	3972493	12380162	9195388	3184774	2314436	50661793	38265033	621362	135304	486058	50661793	40579469	0.6091595109490382	0.48792922687540213	0	0	0	0	0	0	0	0	0	0	0	0	0	0
2021-07-23	89496720	66576376	35080510	31495866	8188864	4184048	4004816	12398716	9196731	3201985	2332764	50794053	38702667	569894	132260	437634	50794053	41035431	0.6107498107025057	0.49341173297089985	0	0	0	0	0	0	0	0	0	0	0	0	0	0
2021-07-24	89707761	66730197	35125280	31604917	8226361	4191354	4035007	12406458	9197496	3208962	2344745	50858875	38848886	211041	64822	146219	50858875	41193631	0.6115292331327133	0.4953139363657173	0	0	0	0	0	0	0	0	0	0	0	0	0	0
2021-07-25	89832120	66814076	35151003	31663073	8257812	4197628	4060184	12409736	9197614	3212122	2350496	50896741	38935379	124359	37866	86493	50896741	41285875	0.6119845354952176	0.49642308206705443	0	0	0	0	0	0	0	0	0	0	0	0	0	0
2021-07-26	90169488	67088210	35212031	31876179	8297626	4207237	4090389	12422078	9198779	3223299	2361574	50979621	39189867	337368	82880	254488	50979621	41551441	0.6129810880702016	0.49961625872159354	0	0	0	0	0	0	0	0	0	0	0	0	0	0
2021-07-27	90719356	67563045	35300219	32262826	8339913	4215997	4123916	12441955	9200086	3241869	2374443	51090745	39628611	549868	111124	438744	51090745	42003054	0.6143172476785814	0.5050464722597964	0	0	0	0	0	0	0	0	0	0	0	0	0	0
2021-07-28	91405906	68165560	35411468	32754092	8386882	4225498	4161384	12465292	9201320	3263972	2388172	51226458	40179448	686550	135713	550837	51226458	42567620	0.6159490664479926	0.5118348373786238	0	0	0	0	0	0	0	0	0	0	0	0	0	0
2021-07-29	91981842	68663520	35506215	33157305	8430353	4234717	4195636	12485082	9202542	3282540	2402887	51346361	40635481	575936	119903	456033	51346361	43038368	0.617390785118339	0.5174951309544993	0	0	0	0	0	0	0	0	0	0	0	0	0	0
2021-07-30	92477658	69080805	35590371	33490434	8475625	4243741	4231884	12502245	9203612	3298633	2418983	51456707	41020951	495816	110346	385470	51456707	43439934	0.6187175900222867	0.5223235772784137	0	0	0	0	0	0	0	0	0	0	0	0	0	0
2021-07-31	92672356	69221134	35631167	33589967	8511489	4249999	4261490	12508263	9203767	3304496	2431470	51516403	41155953	194698	59696	135002	51516403	43587423	0.6194353772148089	0.5240969911627261	0	0	0	0	0	0	0	0	0	0	0	0	0	0
2021-08-01	92789079	69304597	35657363	33647234	8536559	4254180	4282379	12510579	9203849	3306730	2437344	51552736	41236343	116723	36333	80390	51552736	43673687	0.6198722467214075	0.5251342330947776	0	0	0	0	0	0	0	0	0	0	0	0	0	0
2021-08-02	93081392	69543137	35710227	33832910	8569952	4259326	4310626	12519704	9204423	3315281	2448599	51622575	41458817	292313	69839	222474	51622575	43907416	0.6207119937687569	0.5279446003341409	0	0	0	0	0	0	0	0	0	0	0	0	0	0
2021-08-03	93540989	69939246	35781376	34157870	8608320	4264233	4344087	12531639	9205150	3326489	2461784	51712543	41828446	459597	89968	369629	51712543	44290230	0.6217937727512153	0.5325475718283484	0	0	0	0	0	0	0	0	0	0	0	0	0	0
2021-08-04	94110485	70448389	35872098	34576291	8644627	4269911	4374716	12542897	9205649	3337248	2474572	51822230	42288255	569496	109687	459809	51822230	44762827	0.6231126538116916	0.5382300978573026	0	0	0	0	0	0	0	0	0	0	0	0	0	0
2021-08-05	94625646	70901518	35951654	34949864	8684363	4275166	4409197	12550840	9206256	3344584	2488925	51922001	42703645	515161	99771	415390	51922001	45192570	0.6243123044748037	0.5433973456038198	0	0	0	0	0	0	0	0	0	0	0	0	0	0
2021-08-06	95064232	71281770	36026348	35255422	8720199	4280917	4439282	12558141	9206686	3351455	2504122	52018073	43046159	438586	96072	342514	52018073	45550281	0.625467478207717	0.547698477579569	0	0	0	0	0	0	0	0	0	0	0	0	0	0
2021-08-07	95248379	71419573	36062376	35357197	8752036	4285628	4466408	12559684	9206766	3352918	2517086	52071856	43176523	184147	53783	130364	52071856	45693609	0.6261141672417465	0.5494218594264236	0	0	0	0	0	0	0	0	0	0	0	0	0	0
2021-08-08	95364318	71508846	36082966	35425880	8773791	4288392	4485399	12560604	9206808	3353796	2521077	52099243	43265075	115939	27387	88552	52099243	45786152	0.626443469671417	0.550534600316225	0	0	0	0	0	0	0	0	0	0	0	0	0	0
2021-08-09	95657177	71745936	36129348	35616588	8815266	4292908	4522358	12565931	9207115	3358816	2530044	52159415	43497762	292859	60172	232687	52159415	46027806	0.6271669803077821	0.5534402580859547	0	0	0	0	0	0	0	0	0	0	0	0	0	0
2021-08-10	96084061	72111059	36197867	35913192	8857919	4297929	4559990	12573795	9207681	3366114	2541288	52244765	43839296	426884	85350	341534	52244765	46380584	0.6281932322657319	0.557682075464064	0	0	0	0	0	0	0	0	0	0	0	0	0	0
2021-08-11	96623026	72577621	36293152	36284469	8904937	4305712	4599225	12583485	9208352	3375133	2556983	52364199	44258827	538965	119434	419531	52364199	46815810	0.6296293116605273	0.5629152510311487	0	0	0	0	0	0	0	0	0	0	0	0	0	0
2021-08-12	97092739	72983328	36385622	36597706	8943288	4312481	4630807	12590465	9208862	3381603	2575658	52482623	44610116	469713	118424	351289	52482623	47185774	0.6310532467732192	0.5673637135896837	0	0	0	0	0	0	0	0	0	0	0	0	0	0
2021-08-13	97514009	73337375	36472743	36864632	8984440	4319696	4664744	12596989	9209351	3387638	2595205	52596995	44917014	421270	114372	306898	52596995	47512219	0.632428460468997	0.5712889018780604	0	0	0	0	0	0	0	0	0	0	0	0	0	0
2021-08-14	97707503	73482486	36518324	36964162	9016187	4324594	4691593	12598360	9209422	3388938	2610470	52662810	45044693	193494	65815	127679	52662810	47655163	0.6332198227725995	0.5730076664929072	0	0	0	0	0	0	0	0	0	0	0	0	0	0
2021-08-15	97825295	73571025	36545505	37025520	9037348	4327908	4709440	12599045	9209446	3389599	2617877	52700736	45124559	117792	37926	79866	52700736	47742436	0.6336758465776048	0.5740570406830204	0	0	0	0	0	0	0	0	0	0	0	0	0	0
2021-08-16	98088862	73785053	36607362	37177691	9070464	4334163	4736301	12601880	9209718	3392162	2631465	52782708	45306154	263567	81972	181595	52782708	47937619	0.6346614813227374	0.5764039292115327	0	0	0	0	0	0	0	0	0	0	0	0	0	0
2021-08-17	98446600	74092298	36698749	37393549	9099998	4339175	4760823	12607629	9210314	3397315	2646675	52894913	45551687	357738	112205	245533	52894913	48198362	0.6360106389201805	0.5795391139130174	0	0	0	0	0	0	0	0	0	0	0	0	0	0
2021-08-18	98865533	74457195	36809413	37647782	9130013	4345016	4784997	12613671	9210707	3402964	2664654	53029790	45835743	418933	134877	284056	53029790	48500397	0.6376324055907417	0.5831707953438245	0	0	0	0	0	0	0	0	0	0	0	0	0	0
2021-08-19	99195390	74738729	36904769	37833960	9156025	4350290	4805735	12618194	9211276	3406918	2682442	53148777	46046613	329857	118987	210870	53148777	48729055	0.6390631102389032	0.5859201886677953	0	0	0	0	0	0	0	0	0	0	0	0	0	0
2021-08-20	99531464	75025302	37006637	38018665	9179539	4355815	4823724	12623357	9211912	3411445	2703266	53277630	46253834	336074	128853	207221	53277630	48957100	0.6406124440823444	0.588662211254212	0	0	0	0	0	0	0	0	0	0	0	0	0	0
2021-08-21	99683774	75142778	37059384	38083394	9200250	4360020	4840230	12624079	9211973	3412106	2716667	53348044	46335730	152310	70414	81896	53348044	49052397	0.6414591049536635	0.5898080663548183	0	0	0	0	0	0	0	0	0	0	0	0	0	0
2021-08-22	99774814	75212868	37089853	38123015	9215486	4362380	4853106	12624352	9212001	3412351	2722108	53386342	46388472	91040	38298	52742	53386342	49110580	0.6419196017021762	0.5905076611722688	0	0	0	0	0	0	0	0	0	0	0	0	0	0
2021-08-23	100002729	75395770	37160857	38234913	9244035	4367009	4877026	12627945	9212300	3415645	2734979	53475145	46527584	227915	88803	139112	53475145	49262563	0.6429873726760699	0.5923351110999208	0	0	0	0	0	0	0	0	0	0	0	0	0	0
2021-08-24	100289912	75639598	37256414	38383184	9269207	4371160	4898047	12631798	9212980	3418818	2749309	53589863	46700049	287183	114718	172465	53589863	49449358	0.6443667466902713	0.594581141966766	0	0	0	0	0	0	0	0	0	0	0	0	0	0
2021-08-25	100614152	75920743	37364948	38555795	9292801	4375640	4917161	12635517	9213675	3421842	2765091	53719354	46894798	324240	129491	194749	53719354	49659889	0.6459237518723087	0.597112575487084	0	0	0	0	0	0	0	0	0	0	0	0	0	0